body weight	BODY_WEIGHT
BW	BODY_WEIGHT
body	BODY_WEIGHT
weight	BODY_WEIGHT
body-weight	BODY_WEIGHT
heaviness	BODY_WEIGHT
mass	BODY_WEIGHT
density	BODY_WEIGHT
body weight gain	BODY_WEIGHT_GAIN
BG	BODY_WEIGHT_GAIN
body-weight-gain	BODY_WEIGHT_GAIN
clinical	CLINICAL
clinical study	CLINICAL
CL	CLINICAL
cardiovascular	CARDIOVASCULAR
heart condition	CARDIOVASCULAR
cardiovascular system	CARDIOVASCULAR
heart disease	CARDIOVASCULAR
cardiology	CARDIOVASCULAR
cardiovascular abnormality	CARDIOVASCULAR
cardiac muscle	CARDIOVASCULAR
cardiac	CARDIOVASCULAR
CV	CARDIOVASCULAR
cardiotoxicity	CARDIOVASCULAR
macroscopic findings	MACROSCOPIC_FINDINGS
macroscopic	MACROSCOPIC_FINDINGS
MA	MACROSCOPIC_FINDINGS
macroscopical	MACROSCOPIC_FINDINGS
macroscopical findings	MACROSCOPIC_FINDINGS
microscopic findings	MICROSCOPIC_FINDINGS
microscopic	MICROSCOPIC_FINDINGS
MI	MICROSCOPIC_FINDINGS
microscopical	MICROSCOPIC_FINDINGS
microscopical findings	MICROSCOPIC_FINDINGS
organ measurement	ORGAN_MEASUREMENT
organ-measurement	ORGAN_MEASUREMENT
pharmacokinetics	PHARMACOKINETICS_PARAMETERS
pharmacological medicine	PHARMACOKINETICS_PARAMETERS
pharmacology	PHARMACOKINETICS_PARAMETERS
PP	PHARMACOKINETICS_PARAMETERS
tumor finding	TUMOR_FINDINGS
tumor	TUMOR_FINDINGS
TF	TUMOR_FINDINGS
cancerous growth	TUMOR_FINDINGS
malignant growth	TUMOR_FINDINGS
cancer	TUMOR_FINDINGS
tumefaction	TUMOR_FINDINGS
sarcoma	TUMOR_FINDINGS
carcinoma	TUMOR_FINDINGS
neoplasm	TUMOR_FINDINGS
tumor examination	TUMOR_FINDINGS
respiratory findings	RESPIRATORY_FINDINGS	
respiratory examination	RESPIRATORY_FINDINGS
respiratory inspection	RESPIRATORY_FINDINGS
RE	RESPIRATORY_FINDINGS
respiratory system	RESPIRATORY_FINDINGS
pulmonary system	RESPIRATORY_FINDINGS
pulmonary examination	RESPIRATORY_FINDINGS
pulmonary inspection	RESPIRATORY_FINDINGS
cause of death	DEATH_DIAGNOSIS
death	DEATH_DIAGNOSIS
DD	DEATH_DIAGNOSIS
death diagnosis	DEATH_DIAGNOSIS
death	DEATH_DIAGNOSIS
necrosis	DEATH_DIAGNOSIS
necrosis diagnosis	DEATH_DIAGNOSIS
cause of necrosis	DEATH_DIAGNOSIS
dead details	DEATH_DIAGNOSIS
death diagnosis	DEATH_DIAGNOSIS
food	FOOD_WATER_CONSUMPTION
water	FOOD_WATER_CONSUMPTION
drinking	FOOD_WATER_CONSUMPTION
consumption	FOOD_WATER_CONSUMPTION
food consumption	FOOD_WATER_CONSUMPTION
water consumption	FOOD_WATER_CONSUMPTION
FW	FOOD_WATER_CONSUMPTION
ecg	ECG
electrocardiographic	ECG
laboratory findings	LABORATORY_FINDINGS
vital signs	VITAL_SIGNS
	
	
	
	
	
	
	
	
	
	
	
	
	
	
	
	
	
	
	
	
	
	
	
	
	
	
	
	
	
	
	
	
	
	
	
	
	
	
	
	
	
	
	
	
	
	
	
	
	
	
	
	
	
	
	
	
	
	
	
	
	
	
	
	
	
	
	
	
	
	
	
	
	
	
	
	
	
	
	
	
	
	
	
	
	
	
	
	
	
	
	
	
	
	
	
	
	
	
	
	
	
	
	
	
	
	
	
	
	
	
	
	
	
	
	
	
	
	
	
	
	
	
	
	
	
	
	
	
	
	
	
	
	
	
	
	
	
	
	
	
	
	
	
	
	
	
	
	
	
	
	
	
	
	
	
	
	
	
	
	
	
	
	
	
	
	
	
	
	
	
	
	
	
	
	
	
	
	
	
	
	
	
	
	
	
	
	
	
	
	
	
	
	
	
	
	
	
	
	
	
	
	
	
	
	
	
	
	
	
	
	
	
	
	
	
	
	
	
	
	
	
	
	
	
	
	
	
	
	
	
	
	
	
	
	
	
	
	
	
	
	
	
	
	
	
	
	
	
	
	
	
	
	
	
	
	
	
	
	
	
	
	
	
	
	
	
	
	
	
	
	
	
	
	
	
	
	
	
	
	
	
	
	
	
	
	
	
	
	
	
	
	
	
	
	
	
	
	
	
	
	
	
	
	
	
	
	
	
	
	
	
	
	
	
	
	
	
	
	
	
	
	
	
	
	
	
	
	
	
	
	
	
	
	
	
	
	
	
	
	
	
	
	
	
	
	
	
	
	
	
	
	
	
	
	
	
	
	
	
	
	
	
	
	
	
	
	
	
	
	
	
	
	
	
	
	
	
	
	
	
	
	
	
	
	
	
	
	
	
	
	
	
	
	
	
	
	
	
	
	
	
	
	
	
	
	
	
	
	
	
	
	
	
	
	
	
	
	
	
	
	
	
	
	
	
	
	
	
	
	
	
	
	
	
	
	
	
	
	
	
	
	
	
	
	
	
	
	
	
	
	
	
	
	
	
	
	
	
	
	
	
	
	
	
	
	
	
	
	
	
	
	
	
	
	
	
	
	
	
	
	
	
	
	
	
	
	
	
	
	
	
	
	
	
	
	
	
	
	
	
	
	
	
	
	
	
	
	
	
	
	
	
	
	
	
	
	
	
	
	
	
	
	
	
	
	
	
	
	
	
	
	
	
	
	
	
	
	
	
	
	
	
	
	
	
	
	
	
	
	
	
	
	
	
	
	
	
	
	
	
	
	
	
	
	
	
	
	
	
	
	
	
	
	
	
	
	
	
	
	
	
	
	
	
	
	
	
	
	
	
	
	
	
	
	
	
	
	
	
	
	
	
	
	
	
	
	
	
	
	
	
	
	
	
	
	
	
	
	
	
	
	
	
	
	
	
	
	
	
	
	
	
	
	
	
	
	
	
	
	
	
	
	
	
	
	
	
	
	
	
	
	
	
	
	
	
	
	
	
	
	
	
	
	
	
	
	
	
	
	
	
	
	
	
	
	
	
	
	
	
	
	
	
	
	
	
	
	
	
	
	
	
	
	
	
	
	
	
	
	
	
	
	
	
	
	
	
	
	
	
	
	
	
	
	
	
	
	
	
	
	
	
	
	
	
	
	
	
	
	
	
	
	
	
	
	
	
	
	
	
	
	
	
	
	
	
	
	
	
	
	
	
	
	
	
	
	
	
	
	
	
	
	
	
	
	
	
	
	
	
	
	
	
	
	
	
	
	
	
	
	
	
	
	
	
	
	
	
	
	
	
	
	
	
	
	
	
	
	
	
	
	
	
	
	
	
	
	
	
	
	
	
	
	
	
	
	
	
	
	
	
	
	
	
	
	
	
	
	
	
	
	
	
	
	
	
	
	
	
	
	
	
	
	
	
	
	
	
	
	
	
	
	
	
	
	
	
	
	
	
	
	
	
	
	
	
	
	
	
	
	
	
	
	
	
	
	
	
	
	
	
	
	
	
	
	
	
	
	
	
	
	
	
	
	
	
	
	
	
	
	
	
	
	
	
	
	
	
	
	
	
	
	
	
	
	
	
	
	
	
	
	
	
	
	
	
	
	
	
	
	
	
	
	
	
	
	
	
	
	
	
	
	
	
	
	
	
	
	
	
	
	
	
	
	
	
	
	
	
	
	
	
	
	
	
	
	
	
	
	
	
	
	
	
	
	
	
	
	
	
	
	
	
	
	